111111111111111
100000000000001
11000CCP0100001
100000E11101111
100000000000001
111111111111111